 4, 4, 4, 4, 4, 4, 4, 4, 4, 4
 1, 1, 1, 1, 1, 1, 1, 1, 1, 1
 1, 5, 2, 2,10, 2, 2, 2, 6, 1
 1, 3, 9, 9, 3, 1, 9, 9, 3, 1
 1, 3, 1, 9, 3, 1, 9, 1, 3, 1
 1,13, 9, 9,16, 2, 2, 2,12, 1
 1, 3, 9, 1, 3, 1, 9, 9, 3, 1
 1, 8, 2, 2,11, 2, 2, 2, 7, 1
 1, 1, 1, 1, 1, 1, 1, 1, 1, 1
15,15,15,15,15,15,15,15,15,15
14,14,14,14,14,14,14,14,14,14
